A	ǍĂÂÃÄÀÁĀĄÆ
B	ƁƂƄɃ
C	ČĊĈÇĆƇ
D	ĎḊḌḎḐḒƊ
E	ĚĔÊËÈÉĒĘƎƐ
F	ƑḞ
G	ǦĠĜĞĢƓ
H	ȞĤĦḢḤḦḨḪ
I	ǏĬÎÏÌÍĪĮƗ
J	ĴɈ
K	ǨḰḲḴƘ
L	ĽĹĻĿŁḶḸḺḼ
M	ḾṀṂ
N	ŇŃŅṄṆṈṊ
O	ǑŎÔÖÒÓŌÕØŒ
P	ṔṖƤ
Q	Ɋ
R	ŘŔŖṘṚṜṞ
S	ŠŚŜŞṠṢṤṦṨ
T	ŤŢṬṮṰ
U	ǓŬÛÜÙÚŪŲŮŰǗǛǙǕ
V	ṼṾ
W	ŴẀẂŴẄẆẈ
X	ẊẌ
Y	ŶÝŸȲẎỲỸỶỴ
Z	ŽŹŻẐẒẔ
a	ǎăâãäàáāąæ
b	ɓƃƅɓ
c	čċĉçćƈ
d	ďḋḍḏḑḓɗ
e	ěĕêëèéēęǝɛ
f	ƒḟ
g	ǧġĝğģɠ
h	ȟĥħḣḥḧḩḫ
i	ǐĭîïìíīįɨ
j	ĵɉ
k	ǩḱḳḵƙ
l	ľĺļŀłḷḹḻḽ
m	ḿṁṃ
n	ňńņṅṇṉṋ
o	ǒŏôöòóōõøœ
p	ṕṗƥ
q	ɋ
r	řŕŗṙṛṝṟ
s	šśŝşṡṣṥṧṩ
t	ťţṭṯṱ
u	ǔŭûüùúūųůűǘǜǚǖ
v	ṽṿ
w	ŵẁẃŵẅẇẉ
x	ẋẍ
y	ŷýÿȳẏỳỹỷỵ
z	žźżẑẓẕ 